~~~~~~~~~~~~~~
~============~
~............~
~============~
~............~
~============~
~~~~~~~~~~~~~~
