~~~~~~~~~~~~~
~....=...=..~
~===========~
~..=...=.=..~
~..=....==..~
~..=..=..=..~
~~~~~~~~~~~~~
