~~~~~~~~~~~~~
~...........~
~=======.===~
~..=...=....~
~..=.....=..~
~..=..=..=..~
~~~~~~~~~~~~~
