~~~~~~~~~~~~~
~=....====.=~
~.=.==.=.=..~
~==.=..====.~
~=.=.=..=..=~
~=.==....=.=~
~~~~~~~~~~~~~
