~~~~~~~~~~~~~
~=....====.=~
~..===.=.=..~
~==.=..====.~
~=.=.=..=..=~
~=.==....=.=~
~~~~~~~~~~~~~
